111111111111111
1P00100000000C1
10101011111M101
10100010C010101
1C11110010000E1
111111111111111